#NOTE: Useful to add a basic default loc entry for each tag in 00_countries.txt so that hovering over a tag will show the tag's name in loc (ie. PAP: "Papal States")
MOS = "countries/Moscow.txt"
MSO = "countries/Mosobl.txt"
KLG = "countries/Kaluga Oblast.txt"
TLO = "countries/Tula Oblast.txt"
TVR = "countries/Tver Oblast.txt"
SML = "countries/Smolensk Oblast.txt"
YAR = "countries/Yaroslavl Oblast.txt"
VLM = "countries/Vladimir Oblast.txt"
KSM = "countries/Kostroma Oblast.txt"
KRV = "countries/Kirov Oblast.txt"
PRM = "countries/Perm krai.txt"
EKB = "countries/Sverdlovsk.txt"
IVO = "countries/Ivanovo Oblast.txt"
RYZ = "countries/Ryazan Oblast.txt"
PSK = "countries/Pskov Oblast.txt"
LNO = "countries/Leningrad Oblast.txt"
PGD = "countries/Saint-Petersburg.txt"
NVG = "countries/Novgorod Oblast.txt"
KRL = "countries/Karelia.txt"
MUO = "countries/Murmansk Oblast.txt"
KGD = "countries/Kaliningrad.txt"
LIT = "countries/Lithuania.txt"
LAT = "countries/Latvia.txt"
EST = "countries/Estonia.txt"
VGD = "countries/Vologda Oblast.txt"
ARH = "countries/Arkhangelsk Oblast.txt"
KOR = "countries/Komi.txt"
ADG = "countries/Adygei.txt"
ALK = "countries/AltaiKrai.txt"
AMR = "countries/AmurskiyKrai.txt"
AST = "countries/Astrakhan Oblast.txt"
BSH = "countries/Bashkiria.txt"
BGR = "countries/Belgorod Oblast.txt"
BRY = "countries/Bryansk Oblast.txt"
BUR = "countries/Buryatia.txt"
VZH = "countries/Voronezh Oblast.txt"
DST = "countries/Dagestan.txt"
DNR = "countries/Donetsk.txt"
EAO = "countries/Jew Autonomy Oblast.txt"
ZBK = "countries/Zabaikal Krai.txt"
ZPZ = "countries/Zaporozhie Oblast.txt"
ING = "countries/Ingushetia.txt"
IRK = "countries/Irkutsk Oblast.txt"
KBK = "countries/Kabardino-Balkaria.txt"
KAL = "countries/Kalmykia.txt"
KCH = "countries/Kamchakta Krai.txt"
KCS = "countries/Karachaevo-Cherkesia.txt"
KMO = "countries/Kemerov Oblast.txt"
KRK = "countries/Krasnodar Krai.txt"
KSK = "countries/Krasnyarsk Krai.txt"
KRM = "countries/Krim.txt"
KGS = "countries/Kurgan Oblast.txt"
KRS = "countries/Kursk Oblast.txt"
LPC = "countries/Lipetsk Oblast.txt"
LNR = "countries/Lugansk.txt"
MGD = "countries/Magadan.txt"
MEL = "countries/Mariy-El.txt"
MRD = "countries/Mordovia.txt"
NAO = "countries/Nenetskiy Okrug.txt"
NNG = "countries/Nizhniy_Novgorod.txt"
NSB = "countries/Novosibisrk.txt"
ORL = "countries/Orel.txt"
CCH = "countries/Chechnya.txt"
OST = "countries/Osetia.txt"
STV = "countries/Stavropol.txt"
RST = "countries/Rostov.txt"
SVS = "countries/Sevastopol.txt"
VLG = "countries/Volgograd.txt"
KHR = "countries/Kherson.txt"
DPR = "countries/Dnipro.txt"
KNR = "countries/Kharkov.txt"
YAK = "countries/Yakutia.txt"
YNO = "countries/Yamalo-Nenetsk Okrug.txt"
OMO = "countries/Omsk.txt"
ORO = "countries/Orenburg.txt"
PEO = "countries/Penza.txt"
PRI = "countries/Primorje.txt"
ALR = "countries/AltaiRepublic.txt"
SAM = "countries/Samara.txt"
SAH = "countries/Sakhalin.txt"
TOM = "countries/Tomsk.txt"
TYV = "countries/Tyva.txt"
TYM = "countries/Tyumen.txt"
UDM = "countries/Udmurtia.txt"
ULO = "countries/Uljanovsk.txt"
HAB = "countries/Khabarovsk.txt"
HAK = "countries/Khakasia.txt"
HMO = "countries/Hanty-Mansi.txt"
CHL = "countries/Chelyaba.txt"
CHV = "countries/Chuvashia.txt"
CHK = "countries/Chukotka.txt"
TAT = "countries/Tatarstan.txt"
SAR = "countries/Saratov.txt"
TAM = "countries/Tambov.txt"
AKT = "countries/Aktobe.txt"
AKM = "countries/Akmolinsk.txt"
ATY = "countries/Atyrau.txt"
BRS = "countries/Brest.txt"
VOL = "countries/Volyn.txt"
VIN = "countries/Vinnica.txt"
VIT = "countries/Vitebsk.txt"
VOK = "countries/East Kasakhstan.txt"
HOM = "countries/Homel.txt"
HRO = "countries/Hrodno.txt"
ZHM = "countries/Zhambyl.txt"
ZAK = "countries/Zakarpatje.txt"
ZOK = "countries/West Kazakhstan.txt"
ZHT = "countries/Zhitomyr.txt"
KAR = "countries/Karaganda.txt"
KIV = "countries/Kiev.txt"
IFO = "countries/Ivano-Frankovsk.txt"
KIO = "countries/Kiev Oblast.txt"
CHO = "countries/Chernovits.txt"
CHG = "countries/Chernigov.txt"
CHS = "countries/Cherkasy.txt"
HML = "countries/Hmelnitsky.txt"
TEO = "countries/Ternopol.txt"
SUM = "countries/Symi.txt"
ROV = "countries/Rovno.txt"
POL = "countries/Poltava.txt"
PAO = "countries/Pavlodar.txt"
ODO = "countries/Odessa.txt"
NIO = "countries/Nikolaev.txt"
MGO = "countries/Mogilev.txt"
MIO = "countries/Minsk Oblast.txt"
MIN = "countries/Minsk Oblast.txt"
MAN = "countries/Mangystau.txt"
LVV = "countries/Lvov.txt"
KYZ = "countries/Kyzylorda.txt"
KOS = "countries/Kostanai.txt"
KGR = "countries/Kirovograd.txt"
NOK = "countries/North Kazakhstan.txt"
ALM = "countries/Almaty.txt"
ALO = "countries/Almaty Oblast.txt"
STN = "countries/Astana.txt"
SOK = "countries/South Kazakhstan.txt"