OVA = "countries/SOVA.txt"
OMS = "countries/Omsk.txt"
OIL = "countries/Oil_Syndicate.txt"
IRO = "countries/Iron_front.txt"
ARZ = "countries/Arzamas.txt"
BRY = "countries/Bryansk.txt"
VOR = "countries/Voronezh.txt"
OLN = "countries/Olonets.txt"
IZH = "countries/Izhevsk.txt"
KIE = "countries/Kiev.txt"
TVR = "countries/Tver.txt"
TUL = "countries/Tula.txt"
LEN = "countries/Leningrad.txt"
RZN = "countries/Ryazan.txt"
RST = "countries/Rostov.txt"
STP = "countries/Stepnoy.txt"
PTR = "countries/Petropavlovsk.txt"
VLD = "countries/Vladivostok.txt"
TRN = "countries/Terney.txt"
PST = "countries/Wasteland.txt"
EMB = "countries/Emba.txt"
LOG = "countries/Skull_Den.txt"
KUL = "countries/Fist_Band.txt"
PAU = "countries/Spider_Band.txt"
KRS = "countries/Cross_Nest.txt"
KRV = "countries/Red_Wolves_Nest.txt"
ORL = "countries/Eagles_Nest.txt"
UBI = "countries/Izhevsk_Bandits.txt"
UBB = "countries/Baikal_Band.txt"
UHB = "countries/Khabarovsk_Band.txt"
USB = "countries/Sangar_Band.txt"
UMB = "countries/Magadan_Band.txt"
UKB = "countries/Kamchatka_Band.txt"
UMR = "countries/Muroran_Band.txt"
UMG = "countries/Magdeburg_Band.txt"
UZD = "countries/Golden_Dragon_Band.txt"
